"filename", "language", "Markdown", "C", "Lex", "C++", "YACC", "comment", "blank", "total"
"/Users/bharaths/Downloads/S5-CD-Lab/Exp01/README.md", "Markdown", 2, 0, 0, 0, 0, 0, 1, 3
"/Users/bharaths/Downloads/S5-CD-Lab/Exp01/lex.yy.c", "C", 0, 1099, 0, 0, 0, 365, 323, 1787
"/Users/bharaths/Downloads/S5-CD-Lab/Exp01/pgm1.c", "C", 0, 90, 0, 0, 0, 13, 18, 121
"/Users/bharaths/Downloads/S5-CD-Lab/Exp01/pgm1.l", "Lex", 0, 0, 16, 0, 0, 0, 3, 19
"/Users/bharaths/Downloads/S5-CD-Lab/Exp02/README.md", "Markdown", 15, 0, 0, 0, 0, 0, 2, 17
"/Users/bharaths/Downloads/S5-CD-Lab/Exp02/count/lex.yy.c", "C", 0, 1082, 0, 0, 0, 361, 325, 1768
"/Users/bharaths/Downloads/S5-CD-Lab/Exp02/count/pgm2.4.l", "Lex", 0, 0, 19, 0, 0, 0, 4, 23
"/Users/bharaths/Downloads/S5-CD-Lab/Exp02/keywords/lex.yy.c", "C", 0, 1086, 0, 0, 0, 360, 326, 1772
"/Users/bharaths/Downloads/S5-CD-Lab/Exp02/keywords/pgm2.1.l", "Lex", 0, 0, 18, 0, 0, 0, 5, 23
"/Users/bharaths/Downloads/S5-CD-Lab/Exp02/uppercase/lex.yy.c", "C", 0, 1071, 0, 0, 0, 360, 325, 1756
"/Users/bharaths/Downloads/S5-CD-Lab/Exp02/uppercase/pgm2.2.l", "Lex", 0, 0, 17, 0, 0, 0, 4, 21
"/Users/bharaths/Downloads/S5-CD-Lab/Exp02/vowels/lex.yy.c", "C", 0, 1078, 0, 0, 0, 361, 324, 1763
"/Users/bharaths/Downloads/S5-CD-Lab/Exp02/vowels/pgm2.3.l", "Lex", 0, 0, 20, 0, 0, 0, 4, 24
"/Users/bharaths/Downloads/S5-CD-Lab/Exp03/README.md", "Markdown", 18, 0, 0, 0, 0, 0, 2, 20
"/Users/bharaths/Downloads/S5-CD-Lab/Exp03/calc/evalexp.l", "Lex", 0, 0, 16, 0, 0, 0, 3, 19
"/Users/bharaths/Downloads/S5-CD-Lab/Exp03/calc/evalexp.y", "YACC", 0, 0, 0, 0, 33, 0, 5, 38
"/Users/bharaths/Downloads/S5-CD-Lab/Exp03/calc/lex.yy.c", "C", 0, 1087, 0, 0, 0, 361, 323, 1771
"/Users/bharaths/Downloads/S5-CD-Lab/Exp03/calc/y.tab.c", "C", 0, 883, 0, 0, 0, 271, 233, 1387
"/Users/bharaths/Downloads/S5-CD-Lab/Exp03/calc/y.tab.h", "C++", 0, 0, 0, 35, 0, 37, 13, 85
"/Users/bharaths/Downloads/S5-CD-Lab/Exp03/check_expr/check_expr.y", "YACC", 0, 0, 0, 0, 42, 0, 10, 52
"/Users/bharaths/Downloads/S5-CD-Lab/Exp03/check_expr/y.tab.c", "C", 0, 837, 0, 0, 0, 269, 228, 1334
"/Users/bharaths/Downloads/S5-CD-Lab/Exp03/variable_name/lex.yy.c", "C", 0, 1079, 0, 0, 0, 361, 324, 1764
"/Users/bharaths/Downloads/S5-CD-Lab/Exp03/variable_name/var.l", "Lex", 0, 0, 13, 0, 0, 0, 4, 17
"/Users/bharaths/Downloads/S5-CD-Lab/Exp03/variable_name/var.y", "YACC", 0, 0, 0, 0, 29, 0, 10, 39
"/Users/bharaths/Downloads/S5-CD-Lab/Exp03/variable_name/y.tab.c", "C", 0, 822, 0, 0, 0, 271, 226, 1319
"/Users/bharaths/Downloads/S5-CD-Lab/Exp03/variable_name/y.tab.h", "C++", 0, 0, 0, 35, 0, 37, 13, 85
"/Users/bharaths/Downloads/S5-CD-Lab/Exp04/Pgm1/lex.yy.c", "C", 0, 1085, 0, 0, 0, 362, 324, 1771
"/Users/bharaths/Downloads/S5-CD-Lab/Exp04/Pgm1/pgm4-1.l", "Lex", 0, 0, 16, 0, 0, 0, 4, 20
"/Users/bharaths/Downloads/S5-CD-Lab/Exp04/Pgm2/lex.yy.c", "C", 0, 1143, 0, 0, 0, 361, 325, 1829
"/Users/bharaths/Downloads/S5-CD-Lab/Exp04/Pgm2/pgm4-2.l", "Lex", 0, 0, 15, 0, 0, 11, 2, 28
"/Users/bharaths/Downloads/S5-CD-Lab/Exp04/README.md", "Markdown", 60, 0, 0, 0, 0, 0, 18, 78
"/Users/bharaths/Downloads/S5-CD-Lab/Exp05/README.md", "Markdown", 2, 0, 0, 0, 0, 0, 2, 4
"/Users/bharaths/Downloads/S5-CD-Lab/Exp05/nfatodfa.c", "C", 0, 154, 0, 0, 0, 37, 25, 216
"/Users/bharaths/Downloads/S5-CD-Lab/Exp06/README.md", "Markdown", 2, 0, 0, 0, 0, 0, 1, 3
"/Users/bharaths/Downloads/S5-CD-Lab/Exp06/first.c", "C", 0, 86, 0, 0, 0, 12, 14, 112
"/Users/bharaths/Downloads/S5-CD-Lab/Exp06/firstandfollow.c", "C", 0, 220, 0, 0, 0, 43, 33, 296
"/Users/bharaths/Downloads/S5-CD-Lab/Exp07/README.md", "Markdown", 2, 0, 0, 0, 0, 0, 1, 3
"/Users/bharaths/Downloads/S5-CD-Lab/Exp07/pgm7.c", "C", 0, 68, 0, 0, 0, 5, 15, 88
"/Users/bharaths/Downloads/S5-CD-Lab/Exp08/README.md", "Markdown", 2, 0, 0, 0, 0, 0, 1, 3
"/Users/bharaths/Downloads/S5-CD-Lab/Exp08/pgm8.c", "C", 0, 135, 0, 0, 0, 23, 12, 170
"/Users/bharaths/Downloads/S5-CD-Lab/Exp09/README.md", "Markdown", 2, 0, 0, 0, 0, 0, 1, 3
"/Users/bharaths/Downloads/S5-CD-Lab/Exp09/shift-reduce-parser.c", "C", 0, 73, 0, 0, 0, 12, 11, 96
"/Users/bharaths/Downloads/S5-CD-Lab/Exp10/README.md", "Markdown", 2, 0, 0, 0, 0, 0, 1, 3
"/Users/bharaths/Downloads/S5-CD-Lab/Exp10/three_addr.c", "C", 0, 59, 0, 0, 0, 0, 8, 67
"/Users/bharaths/Downloads/S5-CD-Lab/Exp11/README.md", "Markdown", 2, 0, 0, 0, 0, 0, 1, 3
"/Users/bharaths/Downloads/S5-CD-Lab/Exp11/target_code.c", "C", 0, 64, 0, 0, 0, 7, 11, 82
"/Users/bharaths/Downloads/S5-CD-Lab/README.md", "Markdown", 3, 0, 0, 0, 0, 0, 3, 6
"Total", "-", 112, 13301, 150, 70, 104, 4300, 3871, 21908